11111111111
1CCP1CCCC11
1CC1CCCCEC1
11111111111