11111111111
100P0000001
100C000E001
1000CCC0001
11111111111