11111111111
100P0000001
100C000E001
1000CCC1001
11111111111