11111111111
100P0000001
10010000E01
1000C000001
11111111111